"filename", "language", "TypeScript", "WGSL", "comment", "blank", "total"
"d:\BaiduNetdiskDownload\Web-RTRT\src\bvh.ts", "TypeScript", 231, 0, 6, 15, 252
"d:\BaiduNetdiskDownload\Web-RTRT\src\camera.ts", "TypeScript", 115, 0, 20, 11, 146
"d:\BaiduNetdiskDownload\Web-RTRT\src\computeWorker.ts", "TypeScript", 21, 0, 0, 4, 25
"d:\BaiduNetdiskDownload\Web-RTRT\src\denoiser.ts", "TypeScript", 451, 0, 6, 28, 485
"d:\BaiduNetdiskDownload\Web-RTRT\src\device.ts", "TypeScript", 84, 0, 2, 10, 96
"d:\BaiduNetdiskDownload\Web-RTRT\src\display.ts", "TypeScript", 830, 0, 33, 48, 911
"d:\BaiduNetdiskDownload\Web-RTRT\src\gltf.ts", "TypeScript", 378, 0, 26, 25, 429
"d:\BaiduNetdiskDownload\Web-RTRT\src\light.ts", "TypeScript", 84, 0, 1, 4, 89
"d:\BaiduNetdiskDownload\Web-RTRT\src\main.ts", "TypeScript", 448, 0, 38, 39, 525
"d:\BaiduNetdiskDownload\Web-RTRT\src\modelView.ts", "TypeScript", 64, 0, 18, 31, 113
"d:\BaiduNetdiskDownload\Web-RTRT\src\raytracing.ts", "TypeScript", 544, 0, 6, 18, 568
"d:\BaiduNetdiskDownload\Web-RTRT\src\sample.ts", "TypeScript", 319, 0, 62, 17, 398
"d:\BaiduNetdiskDownload\Web-RTRT\src\screenBuffer.ts", "TypeScript", 71, 0, 0, 4, 75
"d:\BaiduNetdiskDownload\Web-RTRT\src\shaders\FSR2\FSR_common.wgsl", "WGSL", 0, 370, 30, 60, 460
"d:\BaiduNetdiskDownload\Web-RTRT\src\shaders\FSR2\FXAA.wgsl", "WGSL", 0, 212, 61, 70, 343
"d:\BaiduNetdiskDownload\Web-RTRT\src\shaders\FSR2\depthClip.wgsl", "WGSL", 0, 233, 69, 86, 388
"d:\BaiduNetdiskDownload\Web-RTRT\src\shaders\FSR2\display.wgsl", "WGSL", 0, 506, 169, 198, 873
"d:\BaiduNetdiskDownload\Web-RTRT\src\shaders\FSR2\lock.wgsl", "WGSL", 0, 122, 30, 31, 183
"d:\BaiduNetdiskDownload\Web-RTRT\src\shaders\FSR2\racs.wgsl", "WGSL", 0, 122, 67, 17, 206
"d:\BaiduNetdiskDownload\Web-RTRT\src\shaders\FSR2\reconstruct_dilated.wgsl", "WGSL", 0, 212, 59, 77, 348
"d:\BaiduNetdiskDownload\Web-RTRT\src\shaders\basic.instanced.vert.wgsl", "WGSL", 0, 18, 0, 4, 22
"d:\BaiduNetdiskDownload\Web-RTRT\src\shaders\compute.position.wgsl", "WGSL", 0, 50, 10, 5, 65
"d:\BaiduNetdiskDownload\Web-RTRT\src\shaders\denoise\atrous.wgsl", "WGSL", 0, 85, 14, 11, 110
"d:\BaiduNetdiskDownload\Web-RTRT\src\shaders\denoise\denoiseAccum.wgsl", "WGSL", 0, 26, 4, 5, 35
"d:\BaiduNetdiskDownload\Web-RTRT\src\shaders\denoise\denoiseCommon.wgsl", "WGSL", 0, 10, 1, 3, 14
"d:\BaiduNetdiskDownload\Web-RTRT\src\shaders\denoise\filterVariance.wgsl", "WGSL", 0, 54, 2, 9, 65
"d:\BaiduNetdiskDownload\Web-RTRT\src\shaders\denoise\firefly.wgsl", "WGSL", 0, 88, 8, 12, 108
"d:\BaiduNetdiskDownload\Web-RTRT\src\shaders\denoise\preloadInvoker.wgsl", "WGSL", 0, 13, 0, 0, 13
"d:\BaiduNetdiskDownload\Web-RTRT\src\shaders\denoise\temperalAccum.wgsl", "WGSL", 0, 155, 22, 19, 196
"d:\BaiduNetdiskDownload\Web-RTRT\src\shaders\lightUpdate.wgsl", "WGSL", 0, 46, 0, 2, 48
"d:\BaiduNetdiskDownload\Web-RTRT\src\shaders\manager.ts", "TypeScript", 82, 0, 1, 15, 98
"d:\BaiduNetdiskDownload\Web-RTRT\src\shaders\position.frag.wgsl", "WGSL", 0, 7, 0, 0, 7
"d:\BaiduNetdiskDownload\Web-RTRT\src\shaders\raw_display.wgsl", "WGSL", 0, 32, 25, 7, 64
"d:\BaiduNetdiskDownload\Web-RTRT\src\shaders\tracing\BSDF.wgsl", "WGSL", 0, 56, 15, 11, 82
"d:\BaiduNetdiskDownload\Web-RTRT\src\shaders\tracing\accumulate.wgsl", "WGSL", 0, 66, 18, 11, 95
"d:\BaiduNetdiskDownload\Web-RTRT\src\shaders\tracing\common.wgsl", "WGSL", 0, 54, 1, 10, 65
"d:\BaiduNetdiskDownload\Web-RTRT\src\shaders\tracing\light.wgsl", "WGSL", 0, 37, 2, 4, 43
"d:\BaiduNetdiskDownload\Web-RTRT\src\shaders\tracing\rayGen.wgsl", "WGSL", 0, 241, 77, 20, 338
"d:\BaiduNetdiskDownload\Web-RTRT\src\shaders\tracing\reservoir.wgsl", "WGSL", 0, 99, 16, 10, 125
"d:\BaiduNetdiskDownload\Web-RTRT\src\shaders\tracing\sampleInit.wgsl", "WGSL", 0, 112, 15, 15, 142
"d:\BaiduNetdiskDownload\Web-RTRT\src\shaders\tracing\slopeAABBTest.wgsl", "WGSL", 0, 535, 5, 33, 573
"d:\BaiduNetdiskDownload\Web-RTRT\src\shaders\tracing\spatialReuse.wgsl", "WGSL", 0, 102, 16, 11, 129
"d:\BaiduNetdiskDownload\Web-RTRT\src\shaders\tracing\trace.wgsl", "WGSL", 0, 143, 16, 20, 179
"d:\BaiduNetdiskDownload\Web-RTRT\src\shaders\utils.wgsl", "WGSL", 0, 38, 38, 15, 91
"d:\BaiduNetdiskDownload\Web-RTRT\src\shaders\vBuffer.wgsl", "WGSL", 0, 65, 15, 10, 90
"d:\BaiduNetdiskDownload\Web-RTRT\src\util\box.ts", "TypeScript", 43, 0, 1, 2, 46
"d:\BaiduNetdiskDownload\Web-RTRT\src\util\cube.ts", "TypeScript", 40, 0, 7, 2, 49
"d:\BaiduNetdiskDownload\Web-RTRT\src\util\math.ts", "TypeScript", 45, 0, 14, 7, 66
"d:\BaiduNetdiskDownload\Web-RTRT\src\utils.ts", "TypeScript", 4, 0, 0, 1, 5
"d:\BaiduNetdiskDownload\Web-RTRT\src\vBuffer.ts", "TypeScript", 167, 0, 18, 11, 196
"Total", "-", 4021, 3909, 1064, 1078, 10072